000000000011011100
001100101110101010
000001101110010101
110011000110100101
110010011011000101
010000101011001111
000001111011110101
101000000010110011
101010001010110101
110101000000001010
011010000111111010
101010001010110000
101010000000000110